101,스탠다드,100000
102,스탠다드,100000
103,스탠다드,100000
104,스탠다드,100000
105,스탠다드,100000
106,스탠다드,100000
107,스탠다드,100000
108,스탠다드,100000
201,디럭스,150000
202,디럭스,150000
203,디럭스,1800000
204,디럭스,150000
205,디럭스,150000
206,디럭스,150000
207,디럭스,150000
208,디럭스,150000
301,스위트,300000
302,스위트,300000
303,스위트,300000
304,스위트,300000
305,스위트,300000
306,스위트,300000
307,스위트,300000
308,스위트,300000
